AAM	Al Aqsa Martyrs Brigade
ABD	Arab Bank for Economic Development in Africa
ABI	Abia
ABN	ethnic Albanian
ABR	Abrahamic religions
ABU	Abuja
ABW	Aruba
ACC	Arab Cooperation Council
ADA	Adamawa
ADB	Asian Development Bank
ADF	Allied Democratic Forces
ADR	African diasporic religions
AEU	Arab Economic Unity Council
AFB	African Development Bank
AFG	Afghanistan
AFGGOVTAL	Taliban (d.r.)
AFGREBTAL	Taliban (d.r.)
AFL	Armed Forces of Liberia (d.r.)
AFR	Africa
AFU	African Union
AGO	Angola
AGOCAB	Cabinda Enclave
AGOREBUNI	National Union for the Total Independence of Angola (UNITA)
AGR	Agriculture
AIA	Anguilla
AIE	International Energy Agency
AKI	Akwa Ibom
AKP	Justice and Development Party (AKP) (d.r.)
ALA	˚Aland Islands
ALB	Albania
ALC	All Liberia Coalition Party
ALE	Alewi
ALQ	Al Qaeda
AMF	Arab Monetary Fund for Economic and Social Development
AML	Amal Militia
AMN	Amnesty International
AMU	Arab Maghreb Union
ANB	Anambra
AND	Andorra
ANK	Ankara
ANO	Abu Nidal Organization
ANP	All Nigeria People’s Party
ANT	Netherlands Antilles
APE	Org. of Arab Petroleum Exporting Countries (OAPEC)
ARB	Arab (ethnic group)
ARBBTH	Baath Party
ARE	United Arab Emirates
ARG	Argentina
ARL	Arab League
ARM	Armenia
ASA	Asia (region)
ASF	Abu Sayyaf
ASL	South Lebanon Army
ASM	American Samoa
ASN	Association of Southeast Asian Nations (ASEAN)
ATD	Eastern and Southern African Trade and Development Bank
ATG	Antigua and Barbuda
ATH	Agnostic/Atheist
AUS	Australia
AUT	Austria
AZE	Azerbaijan
BAG	Baghdad
BAH	Bahai Faith
BAU	Bauchi
BAY	Bayelsa
BCA	Bank of Central African States (BEAC)
BDI	Burundi
BED	Bedouin
BEL	Belgium
BEN	Benin
BFA	Burkina Faso
BGD	Bangladesh
BGR	Bulgaria
BHF	Bosniak/Croat Federation of Bosnia and Herzegovina (d.r.)
BHR	Bahrain
BHS	Bahamas
BIA	Biafra
BIH	Bosnia and Herzegovina (d.r.)
BIHBHF	Bosniak/Croat Federation of Bosnia and Herzegovina (d.r.)
BIHCRO	Bosnian Croat
BIHMOS	Bosnian Muslim
BIHSER	Bosnian Serb
BIHSRP	Bosnian Serb Republika Srpska (d.r.)
BIS	Bank for International Settlements
BLK	Balkans
BLR	Belarus
BLZ	Belize
BMU	Bermuda
BNU	Benue
BOL	Bolivia
BOM	Bomi
BON	Bong
BOR	Borno
BOU	Bougainville
BRA	Brazil
BRB	Barbados
BRN	Brunei Darussalam
BSN	Yugoslavia’s Republic of Bosnia (d.r.)
BSQ	Basque
BTH	Baath Party
BTN	Bhutan
BUD	Buddhist
BUS	Business
BWA	Botswana
CAB	Cabinda Enclave
CAF	Central African Republic
CAN	Canada
CAP	Grand Cape Mount
CAS	Central Asia
CAU	Caucasus
CEM	Monetary and Economic Community of Central Africa (CEMAC)
CES	Common Market for Eastern and Southern Africa
CEU	Central Europe
CFA	Franc Zone Financial Community of Africa
CFD	Campaign for Democracy
CFR	Central Africa
CHE	Switzerland
CHL	Chile
CHN	China
CHNTIC	Tibet
CHP	Republican People’s Party (CHP) (d.r.)
CHR	Christian
CHRCPT	Coptic
CHRCTH	Catholic
CHRDOX	Orthodox Christian
CHRJHW	Jehovah’s Witnesses
CHRLDS	Latter Day Saints
CHRMRN	Maronite
CHRPRO	Protestant
CHRRAD	“fundamentalist” Christian
CIS	Commonwealth of Independent States
CIV	Cte d’Ivoire (Ivory Coast)
CKM	Chakma
CMN	Communist Party
CMR	Cameroon
CNY	Chechnya
COD	Democratic Republic of the Congo (Kinshasa)
COE	Council of Europe
COG	People’s Republic of the Congo (Brazzaville)
COK	Cook Islands
COL	Colombia
COM	Comoros
CON	Confucian
COP	Cop
CPA	Cocoa Producer’s Alliance
CPC	Association of Coffee Producing Countries
CPT	Coptic
CPV	Cape Verde
CRB	Caribbean
CRC	International Fed. of Red Cross and Red Crescent (ICRC)
CRI	Costa Rica
CRM	Criminal
CRO	ethnic Croat
CRR	Cross River
CSI	Christian Solidarity International
CSK	Czechoslovakia
CSS	Community of Sahel-Saharan States (CENSAD)
CTH	Catholic
CUB	Cuba
CVL	Civilian
CWN	Commonwealth of Nations
CYM	Cayman Islands
CYP	Cyprus
CYPGRK	Greek Cypriot
CYPTRK	Turkish Cypriot
CZA	Czechoslovakia
CZE	Czech Republic
DDR	German Democratic Republic (East Germany)
DEL	Delta
DEU	Germany
DEV	Development
DFL	Democratic Front for the Lib. of Palestine (DLFP)
DFR	Darfur
DJI	Djibouti
DMA	Dominica
DNK	Denmark
DOM	Dominican Republic
DOX	Orthodox
DPI	Duoyuan Printing
DRZ	Druze
DSL	Dev-SOL
DSP	Democratic Left Party (DSP) (d.r.)
DTP	Democratic Society Party (DTP)
DVE	Developing Eight Countries (D-8 Organization for Economic Cooperation)
DYP	True Path Party (DYP) (d.r.)
DZA	Algeria
DZAGOVFLN	National Liberation Front (FLN)
DZAGOVMSP	Movement of the Society for Peace
DZAGOVRND	Democratic National Rally
DZAOPPENN	Ennahda Movement
DZAOPPFIS	Islamic Salvation Front
DZAOPPFLN	National Liberation Front (FLN)
DZAOPPMSP	Movement of the Society for Peace
DZAREBFIS	Islamic Salvation Army
DZAREBGIA	Armed Islamic Group (GIA)
DZAREBGSP	Salafist Group
EAC	East African Community
EAF	Eastern Africa
EAR	East Asian religions
EBO	Ebonyi
EBR	European Bank for Reconstruction and Development
ECA	Economic Community of Central African States
ECU	Ecuador
EDO	Edo
EDU	Education
EEC	European Union
EEU	Eastern Europe
EFT	European Free Trade Association
EGY	Egypt
EGYREBMBR	Muslim Brotherhood
EIN	East Indies (region)
EKI	Ekiti
ELI	Elites
ENN	Ennahda Movement
ENU	Enugu
ENV	Environmental
ERI	Eritrea
ESH	Western Sahara
ESP	Spain
ESPBSQ	Basque
EST	Estonia
ETH	Ethiopia
EUR	Europe
FAO	United Nations Food and Agriculture Organization
FAZ	Virtue Party (Fazilet)
FID	International Federation of Human Rights (FIDH)
FIN	Finland
FIS	Islamic Salvation Front
FJI	Fiji
FLK	Falkland Islands (Malvinas)
FLN	National Liberation Front (FLN)
FRA	France
FRO	Faeroe Islands
FRY	Federal Republic of Yugoslavia
FRYKSV	Kosovo (d.r.)
FRYMNE	Montenegro (d.r.)
FRYSRB	Serbia (d.r.)
FRYVVD	Vojvodina (d.r.)
FSM	Micronesia
FTA	Fatah (d.r.)
GAB	Gabon
GBA	Grand Bassa
GBR	United Kingdom
GBRREBIRA	Irish Republican Army
GCC	Gulf Cooperation Council
GEO	Georgia
GGC	Grand Gedeh
GGY	Guernsey
GHA	Ghana
GIA	Armed Islamic Group (GIA)
GIB	Gibraltar
GIN	Guinea
GLP	Guadeloupe
GMB	Gambia
GME	Democratic Republic of Germany (East Berlin)
GMW	Federal Republic of Germany (Bonn)
GNB	Guinea-Bissau
GNO	gnostic
GNQ	Equatorial Guinea
GOE	Group of Eight (G-8)
GOM	Gombe
GOS	Group of Seven (G-7)
GOV	Government
GRC	Greece
GRD	Grenada
GRK	Greek Cypriot
GRL	Greenland
GRP	Greenpeace
GSP	Salafist Group
GSS	Group of Seventy-Seven (G-77)
GTM	Guatemala
GUF	French Guiana
GUM	Guam
GUY	Guyana
GYP	Gypsy
GZA	Gaza Strip
HAU	Hausa
HCH	UN High Commission for Human Rights
HCR	UN High Commission for Refugees
HDP	Democratic People’s Party (DEHAP/HADEP)
HEZ	Hezbullah
HIN	Hindu
HIP	Highly Indebted Poor Countries (HIPC)
HKG	Hong Kong (Special Administrative Region of China)
HLH	Health
HMS	Hamas (d.r.)
HND	Honduras
HRI	Human Rights
HRV	Croatia (d.r.)
HRVSER	Croatian Serb
HRW	Human Rights Watch
HSD	Hasidic
HTI	Haiti
HUN	Hungary
HUT	Hutu (ethnic group)
IAC	Inter-African Coffee Organization (IACO)
IAD	Intergovernmental Authority on Development (IGAD)
IAE	International Atomic Energy Agency (IAEA)
IAF	Islamic Action Front
IBO	Ibo
ICC	International Criminal Court
ICG	International Crisis Group
ICJ	International Court of Justice (ICJ)
ICO	International Cocoa Organization (ICCO)
IDB	Islamic Development Bank
IDN	Indonesia
IGC	International Grains Council
IGO	Inter-governmental Organization
IGOABD	Arab Bank for Economic Development in Africa
IGOACC	Arab Cooperation Council
IGOADB	Asian Development Bank
IGOAEU	Arab Economic Unity Council
IGOAFB	African Development Bank
IGOAFRAFU	African Union
IGOAFRAGRIAC	Inter-African Coffee Organization (IACO)
IGOAFRBUSCES	Common Market for Eastern and Southern Africa
IGOAFRBUSCFA	Franc Zone Financial Community of Africa
IGOAFRDEVAFB	African Development Bank
IGOAFRDEVATD	Eastern and Southern African Trade and Development Bank
IGOAFRDEVNEP	New Economic Partnership for Africa’s Development
IGOAFROAU	Organization of African Unity (OAU)
IGOAFRPAP	Pan African Parliament
IGOAGRCPA	Cocoa Producer’s Alliance
IGOAGRCPC	Association of Coffee Producing Countries
IGOAGRICO	International Cocoa Organization (ICCO)
IGOAGRIGC	International Grains Council
IGOAMF	Arab Monetary Fund for Economic and Social Development
IGOAMU	Arab Maghreb Union
IGOAPE	Org. of Arab Petroleum Exporting Countries (OAPEC)
IGOARBAPE	Organization of Arab Petroleum Exporting Countries (OAPEC)
IGOARBDEVABD	Arab Bank for Economic Development in Africa
IGOARL	Arab League
IGOASN	Association of Southeast Asian Nations (ASEAN)
IGOATD	Eastern and Southern African Trade and Development Bank
IGOBCA	Bank of Central African States (BEAC)
IGOBIS	Bank for International Settlements
IGOBUSBIS	Bank for International Settlements
IGOBUSGOE	Group of Eight (G-8)
IGOBUSGOS	Group of Seven (G-7)
IGOBUSGSS	Group of Seventy-Seven (G-77)
IGOBUSHIP	Highly Indebted Poor Countries (HIPC)
IGOBUSIMF	International Monetary Fund (IMF)
IGOBUSOPC	Organization of Petroleum Exporting Countries (OPEC)
IGOBUSPRC	Paris Club
IGOBUSWTO	World Trade Organization (WTO)
IGOCAFBCA	Bank of Central African States (BEAC)
IGOCAFCEM	Monetary and Economic Community of Central Africa (CEMAC)
IGOCAFECA	Economic Community of Central African States
IGOCASCIS	Commonwealth of Independent States
IGOCEM	Monetary and Economic Community of Central Africa
IGOCES	Common Market for Eastern and Southern Africa
IGOCFA	Franc Zone Financial Community of Africa
IGOCIS	Commonwealth of Independent States
IGOCOE	Council of Europe
IGOCOPITP	Interpol
IGOCPA	Cocoa Producer’s Alliance
IGOCPC	Association of Coffee Producing Countries
IGOCSS	Community of Sahel-Saharan States (CENSAD)
IGOCWN	Commonwealth of Nations
IGODEVDVE	Developing Eight Countries (D-8 Organization for Economic Cooperation)
IGOEAFDEVIAD	Intergovernmental Authority on Development (IGAD)
IGOEAFEAC	East African Community
IGOEBR	European Bank for Reconstruction and Development
IGOECA	Economic Community of Central African States
IGOEEC	European Union
IGOEFT	European Free Trade Association
IGOEURBUSEFT	European Free Trade Association
IGOEURCOE	Council of Europe
IGOEURDEVEBR	European Bank for Reconstruction and Development
IGOEUREEC	European Union
IGOEURSCE	Council of Security and Cooperation in Europe (OSCE)
IGOGCC	Gulf Cooperation Council
IGOGOE	Group of Eight (G-8) (G-7 plus Russia)
IGOGOS	Group of Seven (G-7)
IGOGSS	Group of Seventy-Seven (G-77)
IGOHIP	Highly Indebted Poor Countries (HIPC)
IGOIAC	Inter-African Coffee Organization (IACO)
IGOIAD	Intergovernmental Authority on Development (IGAD)
IGOICC	International Criminal Court
IGOICO	International Cocoa Organization (ICCO)
IGOIDB	Islamic Development Bank
IGOIGC	International Grains Council
IGOIMF	International Monetary Fund (IMF)
IGOIPU	Inter-Parliamentary Union
IGOITP	Interpol
IGOJUDICC	International Criminal Court
IGOLEGIPU	Inter-Parliamentary Union
IGOMEAACC	Arab Cooperation Council
IGOMEAAEU	Arab Economic Unity Council
IGOMEAAMF	Arab Monetary Fund for Economic and Social Development
IGOMEAAMU	Arab Maghreb Union
IGOMEAARL	Arab League
IGOMOSDEVIDB	Islamic Development Bank
IGOMOSOIC	Organization of Islamic Conferences (OIC)
IGONAFCSS	Community of Sahel-Saharan States (CENSAD)
IGONAT	North Atlantic Treaty Organization (NATO)
IGONEP	New Economic Partnership for Africa’s Development
IGONON	Organization of Non-Aligned Countries
IGOOAS	Organization of American States
IGOOAU	Organization of African Unity (OAU)
IGOOIC	Organization of Islamic Conferences (OIC)
IGOOPC	Organization of Petroleum Exporting Countries (OPEC)
IGOPAP	Pan-African Parliament
IGOPGSGCC	Gulf Cooperation Council
IGOPKO	Peacekeeping force (organization unknown)
IGOPRC	Paris Club
IGOSAA	South Asian Association
IGOSAD	Southern African Development Community
IGOSAFDEVSAD	Southern African Development Community
IGOSASSAA	South Asian Association
IGOSCE	Council of Security and Cooperation in Europe (OSCE)
IGOSEAASN	Association of Southeast Asian Nations (ASEAN)
IGOSEADEVADB	Asian Development Bank
IGOSEASOT	Southeast Asia Collective Defense Treaty (SEATO)
IGOSOT	Southeast Asia Collective Defense Treaty (SEATO)
IGOUEM	Economic and Monetary Union of West Africa (UEMOA)
IGOUNO	United Nations
IGOUNOAGRFAO	United Nations Food and Agriculture Organization
IGOUNOAIE	International Energy Agency
IGOUNODEVWBK	The World Bank
IGOUNOFAO	United Nations Food and Agriculture Organization
IGOUNOHCH	UN High Commission for Human Rights
IGOUNOHCR	UN High Commission for Refugees
IGOUNOHLHWHO	World Health Organization (WHO)
IGOUNOHRIHCH	United Nations High Commission for Human Rights (OHCHR)
IGOUNOIAE	International Atomic Energy Agency (IAEA)
IGOUNOICJ	International Court of Justice (ICJ)
IGOUNOILO	International Labor Organization
IGOUNOJUDICJ	International Court of Justice (ICJ)
IGOUNOJUDWCT	International War Crimes Tribunals
IGOUNOKID	United Nations Children’s Fund (UNICEF)
IGOUNOLABILO	International Labor Organization
IGOUNOREFHCR	United Nations High Commission for Refugees (OHCR)
IGOUNOWBK	World Bank
IGOUNOWCT	International War Crimes Tribunals
IGOUNOWFP	World Food Program
IGOUNOWHO	World Health Organization
IGOWAD	West Africa Development Bank
IGOWAFDEVWAM	West Africa Monetary and Economic Union
IGOWAFUEM	Economic and Monetary Union of West Africa (UEMOA)
IGOWAFWAD	West Africa Development Bank
IGOWAFWAS	Economic Community of West African States (ECOWAS)
IGOWAM	West Africa Monetary and Economic Union
IGOWAS	Economic Community of West African States (ECOWAS)
IGOWEU	Western European Union
IGOWSTNAT	North Atlantic Treaty Organization (NATO)
IGOWTO	World Trade Organization (WTO)
IHF	International Helsinki Federation for Human Rights
IJW	Ijaws
ILO	International Labor Organization
IMF	International Monetary Fund (IMF)
IMG	Internationl Militarized Group
IMGMOSALQ	Al Qaeda
IMGMUSISI	The Islamic State (ISIS)
IMGSEAMOSASF	Abu Sayyaf
IMGSEAMOSJMA	Jemaah Islamiya
IMO	Imo
IMY	Isle of Man
IND	India
INDKAS	Indian-controlled Kashmir
INP	Independent NPFL
INR	Indian religions
INS	Insurgents
INT	Ambiguous international or transnational actor
IOM	International Organization for Migration
IPU	Inter-Parliamentary Union
IRA	Irish Republican Army
IRC	Red Cross
IRL	Ireland
IRN	Iran
IRNREBPMD	People’s Mujahedeen
IRQ	Iraq
IRQBAG	Baghdad
IRQKURKDP	Kurdish Democratic Party (KDP)
IRR	Iranic religions
ISI	The Islamic State (ISIS)
ISJ	Palestinian Islamic Jihad
ISL	Iceland
ISR	Israel
ISRARB	Arab Israeli
ISRGOVCMN	Israeli Communist Party (d.r.)
ISRGOVLBA	Israeli Labor Party (d.r.)
ISRGOVLKD	Likud Party (d.r.)
ISRGOVMRZ	Meretz Party (d.r.)
ISRGOVSHA	Shas Party (d.r.)
ISROPPLBA	Israeli Labor Party (d.r.)
ISROPPLKD	Likud Party (d.r.)
ISROPPMRZ	Meretz Party (d.r.)
ISROPPSHA	Shas Party (d.r.)
ISRSET	Israeli Settlers
IST	Istanbul
ITA	Italy
ITP	Interpol
ITR	Indigenous tribal religions
IZM	Izmir
JAM	Jamaica
JAN	Jain
JEW	Jew
JEWHSD	Hasidic Jew
JEWUDX	Orthodox/Ultra-Orthodox Jew
JHW	Jehovah’s Witnesses
JIG	Jigawa
JMA	Jemaah Islamiya
JOR	Jordan
JOROPPIAF	Islamic Action Front
JPN	Japan
JUD	Judiciary
JUR	International Commission of Jurists
JVP	People’s Liberation Front
KAD	Kaduna
KAM	Kamajor militia
KAN	Kano
KAS	Kashmir
KAT	Katsina
KAZ	Kazakhstan
KDP	Kurdish Democratic Party (KDP)
KEB	Kebbi
KEN	Kenya
KGZ	Kyrgyzstan
KHM	Cambodia
KHMREBKMR	Khmer Rouge
KID	United Nations Children’s Fund (UNICEF)
KIR	Kiribati
KMR	Khmer Rouge
KNA	Saint Kitts-Nevis
KOG	Kogi
KOR	Republic of Korea (Seoul)
KRH	Krahn
KRU	Grand Kru
KSV	Kosovo (d.r.)
KUR	Kurd (ethnic group)
KWA	Kwara
KWT	Kuwait
LAB	Labor
LAG	Lagos
LAM	Latin America
LAO	Laos
LAP	Liberia Action Party (d.r.)
LBA	Israeli Labor Party (d.r.)
LBN	Lebanon
LBNREBAML	Amal Militia
LBNREBASL	South Lebanon Army
LBNREBHEZ	Hezbullah
LBR	Liberia
LBRBOM	Bomi (Liberia)
LBRBON	Bong (Liberia)
LBRCAP	Grand Cape Mount (Liberia)
LBRGBA	Grand Bassa (Liberia)
LBRGGC	Grand Gedeh (Liberia)
LBRGOVLAP	Liberia Action Party (d.r.)
LBRGOVNDP	National Democratic Party of Liberia (d.r.)
LBRGOVNPF	National Patriotic Front of Liberia (NPFL) (d.r.)
LBRGOVUPP	United People’s Party (d.r.)
LBRKRH	Krahn (ethnic group)
LBRKRU	Grand Kru (Liberia)
LBRLOF	Lofa (Liberia)
LBRMAN	Mandingo, Mandingoe (ethnic group)
LBRMNT	Montserrado (Liberia)
LBRMRG	Margibi (Liberia)
LBRMRY	Maryland (Liberia)
LBRNIM	Nimba (Liberia)
LBROPPALC	All Liberia Coalition Party
LBROPPLAP	Liberia Action Party (d.r.)
LBROPPNDM	New Deal Movement
LBROPPNDP	National Democratic Party of Liberia (d.r.)
LBROPPUPP	United People’s Party (d.r.)
LBRREBAFL	Armed Forces of Liberia (d.r.)
LBRREBINP	Independent NPFL
LBRREBLPC	Liberia Peace Council
LBRREBLUR	Liberians United for Reconciliation and Democracy (LURD)
LBRREBNPF	National Patriotic Front of Liberia (NPFL) (d.r.)
LBRREBULM	United Liberation Front for Democracy
LBRRVC	Rivercess (Liberia)
LBRSIN	Sino (Liberia)
LBY	Libya
LCA	Saint Lucia
LDS	Latter Day Saints
LEG	Legislature
LIE	Liechtenstein
LKA	Sri Lanka
LKAREBJVP	People’s Liberation Front
LKD	Likud Party (d.r.)
LOF	Lofa
LPC	Liberia Peace Council
LRA	Lord’s Resistance Army
LSO	Lesotho
LTU	Lithuania
LUR	Liberians United for Reconciliation and Democracy
LUX	Luxembourg
LVA	Latvia
MAC	Macao (Special Administrative Region of China)
MAD	Movement for the Advancement of Democracy (MAD)
MAN	Mandingoe
MAR	Morocco
MARREBPLS	Polisario Guerillas
MAY	controversial status
MBR	Muslim Brotherhood
MCD	Yugoslavia’s Republic of Macedonia (d.r.)
MCO	Monaco
MDA	Moldova
MDF	Movement of Democratic Forces of Casamance
MDG	Madagascar
MDT	Mediterranean
MDV	Maldives
MEA	Middle East
MED	Media
MEX	Mexico
MHL	Marshall Islands
MHP	National Action Party (MHP) (d.r.)
MIL	Military
MKD	Former Yugoslav Republic of Macedonia
MLI	Mali
MLN	millenarian
MLT	Malta
MMR	Myanmar (Burma)
MNC	Multi-national corporation
MNCDPI	Duoyuan Printing
MNE	Montenegro
MNG	Mongolia
MNP	Northern Mariana Islands
MNT	Montserrado
MOD	Moderate
MOS	Muslim
MOSALE	Alewi
MOSDRZ	Druze
MOSRAD	“Fundamentalist,” “radical,” “extremist” Muslim
MOSSFI	Sufi
MOSSHI	Shia
MOSSUN	Sunni
MOZ	Mozambique
MRG	Margibi
MRN	Maronite
MRT	Mauritania
MRY	Maryland
MRZ	Meretz Party (d.r.)
MSF	Medecins Sans Frontieres (Doctors Without Borders)
MSP	Movement of the Society for Peace
MSR	Montserrat
MTQ	Martinique
MUS	Mauritius
MWI	Malawi
MYS	Malaysia
MYT	Mayotte
NAF	North Africa
NAM	Namibia
NAS	Nassarawa
NAT	North Atlantic Treaty Organization (NATO)
NCL	New Caledonia
NDA	National Democratic Alliance
NDC	National Democratic Coalition of Nigeria (NADECO)
NDM	New Deal Movement
NDP	National Democratic Party of Liberia (d.r.)
NDR	Niger Delta Region
NEP	New Economic Partnership for Africa’s Development
NER	Niger
NFK	Norfolk Island
NGA	Nigeria
NGAABI	Abia (Nigeria)
NGAABU	Abuja (Nigeria)
NGAADA	Adamawa (Nigeria)
NGAAKI	Akwa Ibom (Nigeria)
NGAANB	Anambra (Nigeria)
NGABAU	Bauchi (Nigeria)
NGABAY	Bayelsa (Nigeria)
NGABIA	Biafra (Nigeria)
NGABNU	Benue (Nigeria)
NGABOR	Borno (Nigeria)
NGACRR	Cross River (Nigeria)
NGADEL	Delta (Nigeria)
NGAEBO	Edo (Nigeria)
NGAEDO	Edo
NGAEKI	Ekiti (Nigeria)
NGAENU	Enugu (Nigeria)
NGAGOM	Gombe (Nigeria)
NGAHAU	Hausa (ethnic group)
NGAIBO	Ibo, Igbo (ethnic group)
NGAIJW	Ijaws (ethnic group)
NGAIMO	Imo (Nigeria)
NGAJIG	Jigawa (Nigeria)
NGAKAD	Kaduna (Nigeria)
NGAKAN	Kano (Nigeria)
NGAKAT	Katsina (Nigeria)
NGAKEB	Kebbi (Nigeria)
NGAKOG	Kogi (Nigeria)
NGAKWA	Kwara (Nigeria)
NGALAG	Lagos (Nigeria)
NGANAS	Nassarawa (Nigeria)
NGANDR	Niger Delta Region (Nigeria)
NGANGR	Niger (Nigeria)
NGANNG	North Nigeria (Nigeria)
NGAOGO	Ogoni (ethnic group)
NGAOGU	Ogun (Nigeria)
NGAOND	Ondo (Nigeria)
NGAOPPANP	All Nigeria People’s Party
NGAOPPCFD	Campaign for Democracy
NGAOPPNDC	National Democratic Coalition of Nigeria (NADECO)
NGAOSU	Osun (Nigeria)
NGAOYO	Oyo (Nigeria)
NGAPLA	Plateu State (Nigeria)
NGAREBMAD	Movement for the Advancement of Democracy (MAD)
NGARIV	Rivers (Nigeria)
NGASOK	Sokoto (Nigeria)
NGATAR	Taraba (Nigeria)
NGATIV	Tiv (ethnic group, language)
NGAYOB	Yobe (Nigeria)
NGAYRB	Yoruba (ethnic group)
NGAZAM	Zamfara (Nigeria)
NGM	Non-governmental movements
NGMGRP	Greenpeace
NGO	Non-governmental organizations
NGOAMN	Amnesty International
NGOCHRCSI	Christian Solidarity International
NGOCRC	International Fed. of Red Cross and Red Crescent (ICRC)
NGOFID	International Federation of Human Rights (FIDH)
NGOHLHCRC	International Fed. of Red Cross and Red Crescent (ICRC)
NGOHLHIRC	Red Cross
NGOHLHMSF	Medecins Sans Frontieres (Doctors Without Borders)
NGOHLHRCR	Red Crescent
NGOHRIAMN	Amnesty International
NGOHRIFID	International Federation of Human Rights (FIDH)
NGOHRIHRW	Human Rights Watch
NGOHRIIHF	International Helsinki Federation for Human Rights
NGOHRW	Human Rights Watch
NGOICG	International Crisis Group
NGOIHF	International Helsinki Federation for Human Rights
NGOIOM	International Organization for Migration
NGOIRC	Red Cross
NGOJUDJUR	International Commission of Jurists
NGOJUR	International Commission of Jurists
NGOMSF	Medecins Sans Frontieres (Doctors Without Borders)
NGORCR	Red Crescent
NGOREFIOM	International Organization for Migration
NGOUAJ	Union of Arab Journalists
NGOUER	International Academy of Architecture
NGOWEF	World Economic Forum
NGOXFM	Oxfam
NGR	Niger
NIC	Nicaragua
NIM	Nimba
NIU	Niue
NLD	Netherlands
NMR	North America
NNG	North Nigeria
NON	Organization of Non-Aligned Countries
NOR	Norway
NPF	National Patriotic Front of Liberia (NPFL) (d.r.)
NPL	Nepal
NRM	New Religious Movements
NRU	Nauru
NZL	New Zealand
OAS	Organization of American States
OAU	Organization of African Unity (OAU)
OFF	Offshoot
OGO	Ogoni
OGU	Ogun
OIC	Organization of Islamic Conferences (OIC)
OMN	Oman
OND	Ondo
OPC	Organization of Petroleum Exporting Countries (OPEC)
OPP	Political Opposition
OSU	Osun
OYO	Oyo
PAG	Animist/Pagan
PAK	Pakistan
PAKKAS	Pakistani-controlled Kashmir
PAL	Palestinian
PALPLO	Palestine Liberation Organization
PALREBANO	Abu Nidal Organization
PALREBPLF	Palestine Liberation Front
PAN	Panama
PAP	Pan African Parliament
PCN	Pitcairn
PER	Peru
PFL	People’s Front for the Lib. of Palestine (PFLP)
PGS	Persian Gulf
PHL	Philippines
PKK	Kurdistan Workers’ Party (PKK)
PKO	Peacekeeping force (organization unknown)
PLA	Plateu State
PLF	Palestine Liberation Front
PLO	Palestine Liberation Organization
PLS	Polisario Guerillas
PLW	Palau
PMD	People’s Mujahedeen
PNG	Papua New Guinea
PNGBOU	Bougainville
POL	Poland
PRC	Paris Club
PRI	Puerto Rico
PRK	Democratic People’s Rep. of Korea (Pyongyang)
PRO	Protestant
PRT	Portugal
PRY	Paraguay
PSE	Occupied Palestinian Territories
PSEGOVFTA	Fatah (d.r.)
PSEGOVHMS	Hamas (d.r.)
PSEGZA	Gaza Strip
PSEREBAAM	Al Aqsa Martyrs Brigade
PSEREBDFL	Democratic Front for the Liberation of Palestine (DFLP)
PSEREBHMS	Hamas (d.r.)
PSEREBISJ	Palestinian Islamic Jihad
PSEREBPFL	People’s Front for the Liberation of Palestine (PFLP)
PSEWSB	West Bank
PTY	Party
PYF	French Polynesia
QAT	Qatar
RAC	racialist
RAD	Radical
RCR	Red Crescent
REB	Rebels
REF	Refugees
REL	Unspecified Religious
REP	Welfare Party (Refah) (d.r.)
REU	Runion
RIV	Rivers
RND	Democratic National Rally
ROU	Romania
RPF	Rwandan Patriotic Front (d.r.)
RUF	Revolutionary United Front
RUS	Russia
RUSCNY	Chechnya
RVC	Rivercess
RWA	Rwanda
RWAGOVRPF	Rwandan Patriotic Front (d.r.)
RWAUAFRPF	Rwandan Patriotic Front (d.r.)
SAA	South Asian Association
SAD	Southern African Development Community
SAF	Southern Africa
SAM	South America
SAS	South Asia
SAU	Saudi Arabia
SCE	Council of Security and Cooperation in Europe (OSCE)
SCG	Serbia and Montenegro (d.r.)
SCGKSV	Kosovo (d.r.)
SCGMNE	Montenegro (d.r.)
SCGSRB	Serbia (d.r.)
SCGVVD	Vojvodina (d.r.)
SCN	Scandinavia
SDN	Sudan
SDNDFR	Darfur
SDNREBNDA	National Democratic Alliance
SDNREBSPL	Sudan People’s Liberation Army
SEA	Southeast Asia
SEN	Senegal
SENREBMDF	Movement of Democratic Forces of Casamance
SEP	Separatist Rebels
SER	ethnic Serb
SET	Israeli Settlers
SFI	Sufi
SGP	Singapore
SHA	Shas Party (d.r.)
SHI	Shia
SHN	Saint Helena OR Shintoism
SIK	Sikh
SIN	Sino
SJM	Svalbard and Jan Mayen Islands
SLA	Slav
SLB	Solomon Islands
SLE	Sierra Leone
SLEREBKAM	Kamajor militia
SLEREBRUF	Revolutionary United Front
SLN	Yugoslavia’s Republic of Slovenia (d.r.)
SLV	El Salvador
SMR	San Marino
SNL	Sinhalese (ethnic group)
SOE	Southeast Turkey
SOK	Sokoto
SOM	Somalia
SOT	Southeast Asia Collective Defense Treaty (SEATO)
SPL	Sudan People’s Liberation Army
SPM	Saint Pierre and Miquelon
SPY	State Intelligence Services
SRB	Serbia (d.r.)
SRBKSV	Kosovo (d.r.)
SRBKSVABN	Kosovar Albanian
SRBKSVSRB	Kosovar Serb
SRBVVD	Vojvodina (d.r.)
SRP	Bosnian Serb Republika Srpska (d.r.)
SSD	South Sudan
STP	Sao Tome and Principe
SUN	Sunni
SUR	Suriname
SVK	Slovakia
SVN	Slovenia
SWE	Sweden
SWZ	Swaziland
SYC	Seychelles
SYN	syncretic
SYR	Syria
TAL	Taliban (d.r.)
TAM	Tamil (ethnic group)
TAO	Taoist
TAR	Taraba
TCA	Turks and Caicos Islands
TCD	Chad
TER	Terai (region in northern India/southern Nepal)
TGO	Togo
THA	Thailand
TIC	Tibet
TIV	Tiv (ethnic group)
TJK	Tajikistan
TKL	Tokelau
TKM	Turkmenistan
TMP	East Timor (Timor-Leste)
TON	Tonga
TRG	Tuareg (ethnic group)
TRK	ethnic Turk
TTO	Trinidad and Tobago
TUN	Tunisia
TUR	Turkey
TURANK	Ankara
TURGOVAKP	Justice and Development Party (AKP) (d.r.)
TURGOVANP	Motherland Party (ANAP) (d.r.)
TURGOVCHP	Republican People’s Party (CHP) (d.r.)
TURGOVDSP	Democratic Left Party (DSP) (d.r.)
TURGOVDYP	True Path Party (DYP) (d.r.)
TURGOVMHP	National Action Party (MHP) (d.r.)
TURGOVREP	Welfare Party (Refah) (d.r.)
TURIST	Istanbul
TURIZM	Izmir
TURKUR	Kurds in Turkey
TUROPPAKP	Justice and Development Party (AKP) (d.r.)
TUROPPANP	Motherland Party (ANAP) (d.r.)
TUROPPCHP	Republican People’s Party (CHP) (d.r.)
TUROPPDSP	Democratic Left Party (DSP) (d.r.)
TUROPPDTP	Democratic Society Party (DTP)
TUROPPDYP	True Path Party (DYP) (d.r.)
TUROPPFAZ	Virtue Party (Fazilet)
TUROPPHDP	Democratic People’s Party (DEHAP/HADEP)
TUROPPMHP	National Action Party (MHP) (d.r.)
TUROPPREP	Welfare Party (Refah) (d.r.)
TURREBDSL	Dev-Sol
TURREBPKK	Kurdistan Workers’ Party (PKK)
TURSOE	Southeast Turkey
TUT	Tutsi (ethnic group)
TUV	Tuvalu
TWN	Taiwan
TZA	Tanzania
UAF	Unidentified Armed Force
UAJ	Union of Arab Journalists
UDX	Orthodox/Ultra-Orthodox Jew
UEM	Economic and Monetary Union of West Africa (UEMOA)
UER	International Academy of Architecture
UFO	extraterrestrial
UGA	Uganda
UGAREBADF	Allied Democratic Forces
UGAREBLRA	Lord’s Resistance Army
UIG	Uighur (Chinese ethnic minority)
UIS	Unidentified State Actors
UKR	Ukraine
ULM	United Liberation Front for Democracy
UNI	National Union for the Total Ind. of Angola (UNITA)
UNO	United Nations
UPP	United People’s Party (d.r.)
URY	Uruguay
USA	United States
USR	Union of Soviet Socialist Republics (USSR)
UZB	Uzbekistan
VAT	Holy See (Vatican City)
VCT	Saint Vincent and the Grenadines
VEN	Venezuela
VGB	British Virgin Islands
VIR	United States Virgin Islands
VNM	Vietnam
VUT	Vanuatu
VVD	Vojvodina (d.r.)
WAD	West Africa Development Bank
WAF	West Africa
WAM	West Africa Monetary and Economic Union
WAS	Economic Community of West African States (ECOWAS)
WBK	The World Bank
WCT	International War Crimes Tribunals
WEF	World Economic Forum
WEU	Western European Union
WFP	World Food Program
WHO	World Health Organization (WHO)
WLF	Wallis and Futuna Islands
WLN	wellness-centric
WSB	West Bank
WSM	Samoa
WST	“the West”
WTO	World Trade Organization (WTO)
XFM	Oxfam
YEM	Yemen
YMN	North Yemen
YMS	South Yemen
YOB	Yobe
YRB	Yoruba
YUG	Socialist Federal Republic of Yugoslavia (d.r.)
YUGBSN	Yugoslavia’s Republic of Bosnia (d.r.)
YUGHRV	Yugoslavia’s Republic of Croatia (d.r.)
YUGKSV	Kosovo (d.r.)
YUGMCD	Yugoslavia’s Republic of Macedonia (d.r.)
YUGMNE	Montenegro (d.r.)
YUGSLN	Yugoslavia’s Republic of Slovenia (d.r.)
YUGSRB	Yugoslavia’s Republic of Serbia (d.r.)
YUGVVD	Vojvodina (d.r.)
ZAF	South Africa
ZAM	Zamfara
ZMB	Zambia
ZRO	Zoroastrian
ZWE	Zimbabwe
